{
	"tileset" : "chemin.png",
	"terrain" : [
		[2, 2, 2, 2, 2, 2, 9, 10, 11,  2,  2,  2,  2,  2,  2, 2, 2, 2, 2, 2, 2, 9, 10, 11],
		[2, 2, 2, 2, 2, 2, 9, 10, 11,  2,  2,  2,  2,  2,  2, 2, 2, 2, 2, 2, 2, 9, 10, 11],
		[2, 2, 2, 2, 2, 2, 9, 10, 11,  2,  2,  2,  2,  2,  2, 2, 2, 2, 2, 2, 2, 9, 10, 11],
		[2, 2, 2, 2, 2, 2, 9, 10, 11,  2,  2,  2,  2,  2,  2, 2, 2, 2, 2, 2, 2, 9, 10, 11],
		[2, 2, 2, 2, 2, 2, 9, 10, 11,  2,  2,  2,  2,  2,  2, 2, 2, 2, 2, 2, 2, 9, 10, 11],
		[2, 2, 2, 2, 2, 2, 9, 10, 11,  2,  2,  2,  2,  2,  2, 2, 2, 2, 2, 2, 2, 9, 10, 11],
		[2, 2, 2, 2, 2, 2, 9, 10, 11,  6,  6,  6,  6,  6,  6, 6, 6, 6, 6, 6, 2, 9, 10, 11],
		[2, 2, 2, 2, 2, 1, 9, 10, 10, 10, 10, 10, 10, 10, 10,10,10,10,10,10, 1, 9, 10, 10],
		[2, 2, 2, 2, 2, 2, 9, 10, 12, 14, 14, 14, 14, 14, 14,14,14,14,14,14, 2, 9, 10, 12],
		[2, 2, 2, 2, 2, 2, 9, 10, 11,  2,  2,  2,  2,  2,  2, 2, 2, 2, 2, 2, 2, 9, 10, 11],
		[2, 2, 2, 2, 2, 2, 9, 10, 11,  2,  2,  2,  2,  2,  2, 2, 2, 2, 2, 2, 2, 9, 10, 11],
		[2, 2, 2, 2, 2, 2, 9, 10, 11,  2,  2,  2,  2,  2,  2, 2, 2, 2, 2, 2, 2, 9, 10, 11],
		[2, 2, 2, 2, 2, 2, 9, 10, 11,  2,  2,  2,  2,  2,  2, 2, 2, 2, 2, 2, 2, 9, 10, 11],
		[2, 2, 2, 2, 2, 2, 9, 10, 11,  2,  2,  2,  2,  2,  2, 2, 2, 2, 2, 2, 2, 9, 10, 11],
		[2, 2, 2, 2, 2, 2, 9, 10, 11,  2,  2,  2,  2,  2,  2, 2, 2, 2, 2, 2, 2, 9, 10, 11],
		[2, 2, 2, 2, 2, 2, 9, 10, 11,  2,  2,  2,  2,  2,  2, 2, 2, 2, 2, 2, 2, 9, 10, 11],
		[2, 2, 2, 2, 2, 2, 9, 10, 11,  2,  2,  2,  2,  2,  2, 2, 2, 2, 2, 2, 2, 9, 10, 11]
		
	]
}



